11111111111111111111111111111
100000000000000000000000000001
100000000000000000000000000001
100000000000044440000000000001
100000000000044440000000000001
100000000000044440000000000001
100000000000044440000000000001
100000000044444444440000000001
100000000004444444400000000001
100000000000444444000000000001
100000000000044440000000000001
100000000000004400000000000001
100000000000000000000000000001
111111111111111111111111111111
